TractId,16_over_pop,16_over_percent,In labor foce,In labor foce_percent,Civilian labor force,Civilian labor force_percent,Employed_pop,Employed_percent,Unemployed_pop,Unemployed_percent,Armed Force_pop_x,Armed Force_percent,Not in Labor Force_pop,Not in Labor Force_percent,Unemployment Rate
27053103700,3838,3838,3049,79.4,3049,79.4,2866,74.7,183,4.8,0,0,789,20.6,6
27053104000,5857,5857,4614,78.8,4614,78.8,4372,74.6,242,4.1,0,0,1243,21.2,5.2
27053104100,2676,2676,1901,71,1901,71,1861,69.5,40,1.5,0,0,775,29,2.1
27053104900,11000,11000,5846,53.1,5846,53.1,5243,47.7,603,5.5,0,0,5154,46.9,10.3
27053001100,1704,1704,1357,79.6,1357,79.6,1305,76.6,52,3.1,0,0,347,20.4,3.8
27053002400,2107,2107,1731,82.2,1731,82.2,1680,79.7,51,2.4,0,0,376,17.8,2.9
27053003300,1668,1668,1203,72.1,1203,72.1,1083,64.9,120,7.2,0,0,465,27.9,10
27053010600,2285,2285,1733,75.8,1733,75.8,1692,74,41,1.8,0,0,552,24.2,2.4
27053011703,3302,3302,2547,77.1,2547,77.1,2506,75.9,41,1.2,0,0,755,22.9,1.6
27053011704,2511,2511,2039,81.2,2039,81.2,2016,80.3,23,0.9,0,0,472,18.8,1.1
27053012003,4281,4281,2938,68.6,2938,68.6,2884,67.4,54,1.3,0,0,1343,31.4,1.8
27053021503,3769,3769,2547,67.6,2547,67.6,2503,66.4,44,1.2,0,0,1222,32.4,1.7
27053021602,4951,4951,2951,59.6,2951,59.6,2784,56.2,167,3.4,0,0,2000,40.4,5.7
27053022400,3024,3024,2339,77.3,2339,77.3,2197,72.7,142,4.7,0,0,685,22.7,6.1
27053022700,3591,3591,2928,81.5,2928,81.5,2869,79.9,59,1.6,0,0,663,18.5,2
27053023903,2672,2672,1418,53.1,1406,52.6,1334,49.9,72,2.7,12,0.4,1254,46.9,5.1
27053024400,3603,3603,1959,54.4,1959,54.4,1830,50.8,129,3.6,0,0,1644,45.6,6.6
27053024902,1953,1953,1453,74.4,1453,74.4,1421,72.8,32,1.6,0,0,500,25.6,2.2
27053024903,1823,1823,1261,69.2,1261,69.2,1196,65.6,65,3.6,0,0,562,30.8,5.2
27053025201,3840,3840,3113,81.1,3113,81.1,2903,75.6,210,5.5,0,0,727,18.9,6.7
27053025302,3530,3530,2434,69,2434,69,2287,64.8,147,4.2,0,0,1096,31,6
27053025401,3418,3418,2607,76.3,2607,76.3,2500,73.1,107,3.1,0,0,811,23.7,4.1
27053025805,2270,2270,1121,49.4,1121,49.4,1074,47.3,47,2.1,0,0,1149,50.6,4.2
27053026018,5733,5733,4189,73.1,4189,73.1,4141,72.2,48,0.8,0,0,1544,26.9,1.1
27053026402,5377,5377,3958,73.6,3958,73.6,3766,70,192,3.6,0,0,1419,26.4,4.9
27053026404,4477,4477,3169,70.8,3169,70.8,3059,68.3,110,2.5,0,0,1308,29.2,3.5
27053026809,3787,3787,2948,77.8,2948,77.8,2719,71.8,229,6,0,0,839,22.2,7.8
27053027602,4678,4678,3394,72.6,3394,72.6,3275,70,119,2.5,0,0,1284,27.4,3.5
27053102000,2138,2138,1669,78.1,1661,77.7,1443,67.5,218,10.2,8,0.4,469,21.9,13.1
27053103600,2144,2144,1499,69.9,1499,69.9,1496,69.8,3,0.1,0,0,645,30.1,0.2
27053104800,7614,7614,4706,61.8,4706,61.8,4096,53.8,610,8,0,0,2908,38.2,13
27053108700,2972,2972,2098,70.6,2098,70.6,2011,67.7,87,2.9,0,0,874,29.4,4.1
27053105600,4189,4189,3578,85.4,3578,85.4,3449,82.3,129,3.1,0,0,611,14.6,3.6
27053106200,3255,3255,2380,73.1,2380,73.1,2132,65.5,248,7.6,0,0,875,26.9,10.4
27053108600,2287,2287,1859,81.3,1859,81.3,1802,78.8,57,2.5,0,0,428,18.7,3.1
27053109300,3699,3699,3110,84.1,3110,84.1,3002,81.2,108,2.9,0,0,589,15.9,3.5
27053109800,3236,3236,2438,75.3,2438,75.3,2367,73.1,71,2.2,0,0,798,24.7,2.9
27053110200,2857,2857,2287,80,2263,79.2,2204,77.1,59,2.1,24,0.8,570,20,2.6
27053110400,2747,2747,2219,80.8,2219,80.8,2118,77.1,101,3.7,0,0,528,19.2,4.6
27053110800,3725,3725,3024,81.2,3024,81.2,2943,79,81,2.2,0,0,701,18.8,2.7
27053125500,3015,3015,2112,70,2097,69.6,2043,67.8,54,1.8,15,0.5,903,30,2.6
27053104400,2053,2053,1459,71.1,1459,71.1,1328,64.7,131,6.4,0,0,594,28.9,9
27053106700,4373,4373,3764,86.1,3764,86.1,3653,83.5,111,2.5,0,0,609,13.9,2.9
27053106900,2403,2403,1754,73,1754,73,1594,66.3,160,6.7,0,0,649,27,9.1
27053109100,4438,4438,3786,85.3,3786,85.3,3608,81.3,178,4,0,0,652,14.7,4.7
27053026711,2521,2521,1791,71,1791,71,1743,69.1,48,1.9,0,0,730,29,2.7
27053026712,2747,2747,1918,69.8,1918,69.8,1872,68.1,46,1.7,0,0,829,30.2,2.4
27053026910,4187,4187,3117,74.4,3117,74.4,3047,72.8,70,1.7,0,0,1070,25.6,2.2
27053100500,1685,1685,1217,72.2,1217,72.2,1188,70.5,29,1.7,0,0,468,27.8,2.4
27053101600,1775,1775,1196,67.4,1196,67.4,1022,57.6,174,9.8,0,0,579,32.6,14.5
27053102500,2609,2609,1996,76.5,1996,76.5,1947,74.6,49,1.9,0,0,613,23.5,2.5
27053000300,2891,2891,2204,76.2,2204,76.2,2105,72.8,99,3.4,0,0,687,23.8,4.5
27053000601,3964,3964,3048,76.9,3048,76.9,2921,73.7,127,3.2,0,0,916,23.1,4.2
27053002200,904,904,560,61.9,560,61.9,475,52.5,85,9.4,0,0,344,38.1,15.2
27053002700,2033,2033,1449,71.3,1449,71.3,1350,66.4,99,4.9,0,0,584,28.7,6.8
27053020101,2543,2543,1782,70.1,1782,70.1,1752,68.9,30,1.2,0,0,761,29.9,1.7
27053021100,1570,1570,1196,76.2,1196,76.2,1125,71.7,71,4.5,0,0,374,23.8,5.9
27053023501,3179,3179,2076,65.3,2076,65.3,2008,63.2,68,2.1,0,0,1103,34.7,3.3
27053020804,2695,2695,1989,73.8,1989,73.8,1921,71.3,68,2.5,0,0,706,26.2,3.4
27053023000,4107,4107,3313,80.7,3313,80.7,3200,77.9,113,2.8,0,0,794,19.3,3.4
27053025205,3876,3876,2834,73.1,2834,73.1,2688,69.3,146,3.8,0,0,1042,26.9,5.2
27053025906,5158,5158,4180,81,4180,81,4017,77.9,163,3.2,0,0,978,19,3.9
27053026814,5428,5428,4042,74.5,4042,74.5,3936,72.5,106,2,0,0,1386,25.5,2.6
27053027203,3294,3294,2042,62,2042,62,1982,60.2,60,1.8,0,0,1252,38,2.9
27053027400,3245,3245,2124,65.5,2124,65.5,2070,63.8,54,1.7,0,0,1121,34.5,2.5
27053101200,3880,3880,3223,83.1,3223,83.1,3183,82,40,1,0,0,657,16.9,1.2
27053024901,817,817,601,73.6,601,73.6,595,72.8,6,0.7,0,0,216,26.4,1
27053026708,4563,4563,3221,70.6,3221,70.6,3070,67.3,151,3.3,0,0,1342,29.4,4.7
27053026815,4279,4279,3217,75.2,3217,75.2,3097,72.4,120,2.8,0,0,1062,24.8,3.7
27053101900,2262,2262,1602,70.8,1602,70.8,1513,66.9,89,3.9,0,0,660,29.2,5.6
27053026811,4207,4207,3187,75.8,3187,75.8,3086,73.4,101,2.4,0,0,1020,24.2,3.2
27053105700,2683,2683,1963,73.2,1963,73.2,1902,70.9,61,2.3,0,0,720,26.8,3.1
27053106500,3756,3756,2682,71.4,2682,71.4,2615,69.6,67,1.8,0,0,1074,28.6,2.5
27053109400,1576,1576,1260,79.9,1260,79.9,1123,71.3,137,8.7,0,0,316,20.1,10.9
27053100900,3777,3777,2258,59.8,2258,59.8,2062,54.6,196,5.2,0,0,1519,40.2,8.7
27053107400,1555,1555,1131,72.7,1131,72.7,1054,67.8,77,5,0,0,424,27.3,6.8
27053026505,3044,3044,2118,69.6,2118,69.6,2035,66.9,83,2.7,0,0,926,30.4,3.9
27053000603,2382,2382,1848,77.6,1848,77.6,1847,77.5,1,0,0,0,534,22.4,0.1
27053026819,3454,3454,2447,70.8,2436,70.5,2281,66,155,4.5,11,0.3,1007,29.2,6.4
27053100200,3086,3086,2068,67,2068,67,1938,62.8,130,4.2,0,0,1018,33,6.3
27053003800,5780,5780,4749,82.2,4749,82.2,4450,77,299,5.2,0,0,1031,17.8,6.3
27053008300,1466,1466,1053,71.8,1053,71.8,981,66.9,72,4.9,0,0,413,28.2,6.8
27053011800,3874,3874,2941,75.9,2941,75.9,2927,75.6,14,0.4,0,0,933,24.1,0.5
27053012101,2229,2229,1810,81.2,1810,81.2,1771,79.5,39,1.7,0,0,419,18.8,2.2
27053020500,2643,2643,1846,69.8,1846,69.8,1709,64.7,137,5.2,0,0,797,30.2,7.4
27053020801,1545,1545,1058,68.5,1058,68.5,1024,66.3,34,2.2,0,0,487,31.5,3.2
27053020903,2526,2526,1735,68.7,1735,68.7,1707,67.6,28,1.1,0,0,791,31.3,1.6
27053021002,1646,1646,1154,70.1,1154,70.1,1114,67.7,40,2.4,0,0,492,29.9,3.5
27053021502,2944,2944,1845,62.7,1845,62.7,1714,58.2,131,4.4,0,0,1099,37.3,7.1
27053022302,2670,2670,1869,70,1869,70,1820,68.2,49,1.8,0,0,801,30,2.6
27053022901,4308,4308,3261,75.7,3261,75.7,3137,72.8,124,2.9,0,0,1047,24.3,3.8
27053023300,4756,4756,3675,77.3,3675,77.3,3606,75.8,69,1.5,0,0,1081,22.7,1.9
27053023502,4584,4584,3027,66,3027,66,2987,65.2,40,0.9,0,0,1557,34,1.3
27053023600,2869,2869,1889,65.8,1889,65.8,1836,64,53,1.8,0,0,980,34.2,2.8
27053023802,2067,2067,1540,74.5,1540,74.5,1474,71.3,66,3.2,0,0,527,25.5,4.3
27053024500,1908,1908,1420,74.4,1420,74.4,1342,70.3,78,4.1,0,0,488,25.6,5.5
27053024600,3169,3169,2473,78,2473,78,2331,73.6,142,4.5,0,0,696,22,5.7
27053000102,4086,4086,2669,65.3,2669,65.3,2427,59.4,242,5.9,0,0,1417,34.7,9.1
27053007700,3706,3706,3221,86.9,3221,86.9,3193,86.2,28,0.8,0,0,485,13.1,0.9
27053021300,3913,3913,2511,64.2,2511,64.2,2350,60.1,161,4.1,0,0,1402,35.8,6.4
27053021700,4347,4347,2819,64.8,2819,64.8,2795,64.3,24,0.6,0,0,1528,35.2,0.9
27053022101,2287,2287,1918,83.9,1918,83.9,1839,80.4,79,3.5,0,0,369,16.1,4.1
27053022301,2076,2076,1218,58.7,1218,58.7,1192,57.4,26,1.3,0,0,858,41.3,2.1
27053025301,2409,2409,1449,60.1,1449,60.1,1412,58.6,37,1.5,0,0,960,39.9,2.6
27053024004,3849,3849,1788,46.5,1788,46.5,1710,44.4,78,2,0,0,2061,53.5,4.4
27053024200,2514,2514,1907,75.9,1907,75.9,1827,72.7,80,3.2,0,0,607,24.1,4.2
27053024300,4127,4127,3389,82.1,3389,82.1,3222,78.1,167,4,0,0,738,17.9,4.9
27053020302,1811,1811,1268,70,1268,70,1164,64.3,104,5.7,0,0,543,30,8.2
27053020902,1781,1781,1337,75.1,1337,75.1,1307,73.4,30,1.7,0,0,444,24.9,2.2
27053024100,2717,2717,2131,78.4,2131,78.4,2089,76.9,42,1.5,0,0,586,21.6,2
27053026101,2710,2710,1743,64.3,1743,64.3,1705,62.9,38,1.4,0,0,967,35.7,2.2
27053025801,2694,2694,1975,73.3,1975,73.3,1923,71.4,52,1.9,0,0,719,26.7,2.6
27053025803,2663,2663,1900,71.3,1900,71.3,1822,68.4,78,2.9,0,0,763,28.7,4.1
27053026005,3181,3181,2274,71.5,2267,71.3,2161,67.9,106,3.3,7,0.2,907,28.5,4.7
27053026006,2374,2374,1656,69.8,1656,69.8,1612,67.9,44,1.9,0,0,718,30.2,2.7
27053026007,3911,3911,3012,77,3000,76.7,2954,75.5,46,1.2,12,0.3,899,23,1.5
27053026014,4083,4083,2926,71.7,2926,71.7,2854,69.9,72,1.8,0,0,1157,28.3,2.5
27053026202,2271,2271,1456,64.1,1456,64.1,1436,63.2,20,0.9,0,0,815,35.9,1.4
27053026206,2896,2896,1786,61.7,1786,61.7,1751,60.5,35,1.2,0,0,1110,38.3,2
27053026208,2548,2548,1724,67.7,1724,67.7,1661,65.2,63,2.5,0,0,824,32.3,3.7
27053026508,4029,4029,2923,72.5,2923,72.5,2813,69.8,110,2.7,0,0,1106,27.5,3.8
27053026610,3685,3685,2212,60,2212,60,2090,56.7,122,3.3,0,0,1473,40,5.5
27053026702,2347,2347,1437,61.2,1432,61,1384,59,48,2,5,0.2,910,38.8,3.4
27053026716,6427,6427,4869,75.8,4869,75.8,4812,74.9,57,0.9,0,0,1558,24.2,1.2
27053025701,5997,5997,4237,70.7,4237,70.7,4175,69.6,62,1,0,0,1760,29.3,1.5
27053025702,3737,3737,2312,61.9,2312,61.9,2286,61.2,26,0.7,0,0,1425,38.1,1.1
27053025903,5027,5027,3492,69.5,3492,69.5,3376,67.2,116,2.3,0,0,1535,30.5,3.3
27053025905,3027,3027,1542,50.9,1542,50.9,1542,50.9,0,0,0,0,1485,49.1,0
27053026015,4280,4280,3115,72.8,3115,72.8,3023,70.6,92,2.1,0,0,1165,27.2,3
27053026016,5660,5660,4211,74.4,4211,74.4,4114,72.7,97,1.7,0,0,1449,25.6,2.3
27053026509,3657,3657,2732,74.7,2732,74.7,2706,74,26,0.7,0,0,925,25.3,1
27053026810,3991,3991,3090,77.4,3090,77.4,3003,75.2,87,2.2,0,0,901,22.6,2.8
27053026816,4903,4903,3616,73.8,3616,73.8,3492,71.2,124,2.5,0,0,1287,26.2,3.4
27053026818,3527,3527,2434,69,2434,69,2257,64,177,5,0,0,1093,31,7.3
27053026820,8970,8970,6782,75.6,6782,75.6,6632,73.9,150,1.7,0,0,2188,24.4,2.2
27053026907,4435,4435,3201,72.2,3201,72.2,3109,70.1,92,2.1,0,0,1234,27.8,2.9
27053027001,2701,2701,1978,73.2,1978,73.2,1853,68.6,125,4.6,0,0,723,26.8,6.3
27053027503,3242,3242,2226,68.7,2226,68.7,2148,66.3,78,2.4,0,0,1016,31.3,3.5
27053000101,2436,2436,1691,69.4,1691,69.4,1586,65.1,105,4.3,0,0,745,30.6,6.2
27053011998,3479,3479,2564,73.7,2564,73.7,2402,69,162,4.7,0,0,915,26.3,6.3
27053012001,4637,4637,3789,81.7,3775,81.4,3527,76.1,248,5.3,14,0.3,848,18.3,6.6
27053012102,2420,2420,1853,76.6,1853,76.6,1813,74.9,40,1.7,0,0,567,23.4,2.2
27053020200,5348,5348,4104,76.7,4104,76.7,3985,74.5,119,2.2,0,0,1244,23.3,2.9
27053020301,1823,1823,1391,76.3,1391,76.3,1335,73.2,56,3.1,0,0,432,23.7,4
27053021504,2936,2936,2131,72.6,2131,72.6,2081,70.9,50,1.7,0,0,805,27.4,2.3
27053022102,2350,2350,1642,69.9,1642,69.9,1609,68.5,33,1.4,0,0,708,30.1,2
27053024005,2157,2157,1392,64.5,1392,64.5,1380,64,12,0.6,0,0,765,35.5,0.9
27053024006,1660,1660,1056,63.6,1056,63.6,1003,60.4,53,3.2,0,0,604,36.4,5
27053026019,4740,4740,3609,76.1,3609,76.1,3455,72.9,154,3.2,0,0,1131,23.9,4.3
27053026020,4000,4000,2725,68.1,2725,68.1,2509,62.7,216,5.4,0,0,1275,31.9,7.9
27053026104,3677,3677,2810,76.4,2810,76.4,2785,75.7,25,0.7,0,0,867,23.6,0.9
27053026021,3266,3266,2332,71.4,2332,71.4,2270,69.5,62,1.9,0,0,934,28.6,2.7
27053026022,5421,5421,3988,73.6,3988,73.6,3900,71.9,88,1.6,0,0,1433,26.4,2.2
27053026103,2346,2346,1630,69.5,1630,69.5,1545,65.9,85,3.6,0,0,716,30.5,5.2
27053026612,7954,7954,6161,77.5,6148,77.3,6033,75.8,115,1.4,13,0.2,1793,22.5,1.9
27053026613,6846,6846,4915,71.8,4908,71.7,4729,69.1,179,2.6,7,0.1,1931,28.2,3.6
27053026822,3785,3785,2533,66.9,2533,66.9,2462,65,71,1.9,0,0,1252,33.1,2.8
27053026823,3466,3466,2381,68.7,2381,68.7,2217,64,164,4.7,0,0,1085,31.3,6.9
27053105201,2789,2789,2092,75,2092,75,2092,75,0,0,0,0,697,25,0
27053105204,2450,2450,1752,71.5,1752,71.5,1614,65.9,138,5.6,0,0,698,28.5,7.9
27053125600,3381,3381,2416,71.5,2416,71.5,2322,68.7,94,2.8,0,0,965,28.5,3.9
27053125700,2475,2475,1759,71.1,1759,71.1,1489,60.2,270,10.9,0,0,716,28.9,15.3
27053125800,3755,3755,2682,71.4,2682,71.4,2489,66.3,193,5.1,0,0,1073,28.6,7.2
27053125900,3168,3168,2082,65.7,2082,65.7,1952,61.6,130,4.1,0,0,1086,34.3,6.2
27053126000,3908,3908,2314,59.2,2314,59.2,2102,53.8,212,5.4,0,0,1594,40.8,9.2
27053126100,7101,7101,4613,65,4613,65,4324,60.9,289,4.1,0,0,2488,35,6.3
27053126200,5513,5513,4542,82.4,4542,82.4,4339,78.7,203,3.7,0,0,971,17.6,4.5
27053980000,217,217,123,56.7,123,56.7,101,46.5,22,10.1,0,0,94,43.3,17.9
27053111600,2629,2629,2061,78.4,2061,78.4,1979,75.3,82,3.1,0,0,568,21.6,4
27053003200,1385,1385,1063,76.8,1063,76.8,1030,74.4,33,2.4,0,0,322,23.2,3.1
27053006800,3576,3576,3305,92.4,3290,92,3060,85.6,230,6.4,15,0.4,271,7.6,7
27053008400,2199,2199,1694,77,1694,77,1582,71.9,112,5.1,0,0,505,23,6.6
27053020304,2818,2818,2078,73.7,2078,73.7,1987,70.5,91,3.2,0,0,740,26.3,4.4
27053008500,3569,3569,2885,80.8,2885,80.8,2658,74.5,227,6.4,0,0,684,19.2,7.9
27053011000,3066,3066,2313,75.4,2313,75.4,2251,73.4,62,2,0,0,753,24.6,2.7
27053020102,1767,1767,1183,66.9,1183,66.9,1150,65.1,33,1.9,0,0,584,33.1,2.8
27053022000,1659,1659,1459,87.9,1459,87.9,1431,86.3,28,1.7,0,0,200,12.1,1.9
27053023100,1292,1292,963,74.5,963,74.5,925,71.6,38,2.9,0,0,329,25.5,3.9
27053024802,2236,2236,1614,72.2,1585,70.9,1548,69.2,37,1.7,29,1.3,622,27.8,2.3
27053025403,3281,3281,2424,73.9,2424,73.9,2292,69.9,132,4,0,0,857,26.1,5.4
27053025605,2968,2968,2078,70,2078,70,2078,70,0,0,0,0,890,30,0
27053025802,1895,1895,1322,69.8,1317,69.5,1291,68.1,26,1.4,5,0.3,573,30.2,2
27053026207,3000,3000,2120,70.7,2120,70.7,2020,67.3,100,3.3,0,0,880,29.3,4.7
27053026713,3710,3710,2905,78.3,2905,78.3,2829,76.3,76,2,0,0,805,21.7,2.6
27053026714,7774,7774,5428,69.8,5428,69.8,5324,68.5,104,1.3,0,0,2346,30.2,1.9
27053026715,11579,11579,8935,77.2,8935,77.2,8639,74.6,296,2.6,0,0,2644,22.8,3.3
27053026807,4391,4391,3129,71.3,3129,71.3,2952,67.2,177,4,0,0,1262,28.7,5.7
27053026903,3386,3386,2359,69.7,2359,69.7,2201,65,158,4.7,0,0,1027,30.3,6.7
27053026908,4843,4843,4063,83.9,4063,83.9,3962,81.8,101,2.1,0,0,780,16.1,2.5
27053026909,9807,9807,7321,74.7,7321,74.7,7103,72.4,218,2.2,0,0,2486,25.3,3
27053027102,4578,4578,3418,74.7,3418,74.7,3283,71.7,135,2.9,0,0,1160,25.3,3.9
27053101800,3169,3169,2636,83.2,2636,83.2,2520,79.5,116,3.7,0,0,533,16.8,4.4
27053102100,1675,1675,1107,66.1,1107,66.1,1001,59.8,106,6.3,0,0,568,33.9,9.6
27053102300,1087,1087,538,49.5,538,49.5,513,47.2,25,2.3,0,0,549,50.5,4.6
27053102900,923,923,596,64.6,596,64.6,503,54.5,93,10.1,0,0,327,35.4,15.6
27053109700,1944,1944,1578,81.2,1575,81,1488,76.5,87,4.5,3,0.2,366,18.8,5.5
27053109900,3131,3131,2601,83.1,2601,83.1,2499,79.8,102,3.3,0,0,530,16.9,3.9
27053103100,1864,1864,1260,67.6,1260,67.6,1216,65.2,44,2.4,0,0,604,32.4,3.5
27053110100,2185,2185,1809,82.8,1809,82.8,1730,79.2,79,3.6,0,0,376,17.2,4.4
27053111300,3631,3631,2775,76.4,2775,76.4,2703,74.4,72,2,0,0,856,23.6,2.6
27053026906,5966,5966,4839,81.1,4839,81.1,4767,79.9,72,1.2,0,0,1127,18.9,1.5
27053027002,4277,4277,2741,64.1,2741,64.1,2711,63.4,30,0.7,0,0,1536,35.9,1.1
27053027300,3806,3806,2163,56.8,2163,56.8,2100,55.2,63,1.7,0,0,1643,43.2,2.9
27053100400,2236,2236,1546,69.1,1524,68.2,1295,57.9,229,10.2,22,1,690,30.9,15
27053022902,1268,1268,958,75.6,958,75.6,932,73.5,26,2.1,0,0,310,24.4,2.7
27053023700,3831,3831,2529,66,2529,66,2462,64.3,67,1.7,0,0,1302,34,2.6
27053023801,3948,3948,2732,69.2,2732,69.2,2638,66.8,94,2.4,0,0,1216,30.8,3.4
27053023901,2704,2704,1877,69.4,1877,69.4,1836,67.9,41,1.5,0,0,827,30.6,2.2
27053024003,4119,4119,2888,70.1,2888,70.1,2721,66.1,167,4.1,0,0,1231,29.9,5.8
27053024801,1880,1880,1448,77,1448,77,1414,75.2,34,1.8,0,0,432,23,2.3
27053025907,4026,4026,2669,66.3,2669,66.3,2603,64.7,66,1.6,0,0,1357,33.7,2.5
27053026201,2578,2578,1714,66.5,1714,66.5,1643,63.7,71,2.8,0,0,864,33.5,4.1
27053026205,2657,2657,1921,72.3,1921,72.3,1887,71,34,1.3,0,0,736,27.7,1.8
27053026511,3055,3055,2412,79,2412,79,2359,77.2,53,1.7,0,0,643,21,2.2
27053026301,3173,3173,2072,65.3,2072,65.3,2044,64.4,28,0.9,0,0,1101,34.7,1.4
27053026302,2733,2733,1801,65.9,1801,65.9,1727,63.2,74,2.7,0,0,932,34.1,4.1
27053026507,4003,4003,3169,79.2,3169,79.2,3128,78.1,41,1,0,0,834,20.8,1.3
27053026706,3123,3123,2130,68.2,2130,68.2,2059,65.9,71,2.3,0,0,993,31.8,3.3
27053026710,7747,7747,5656,73,5634,72.7,5492,70.9,142,1.8,22,0.3,2091,27,2.5
27053026812,5314,5314,3775,71,3763,70.8,3682,69.3,81,1.5,12,0.2,1539,29,2.2
27053027202,1436,1436,1021,71.1,1021,71.1,946,65.9,75,5.2,0,0,415,28.9,7.3
27053027504,2685,2685,1694,63.1,1694,63.1,1586,59.1,108,4,0,0,991,36.9,6.4
27053027700,7360,7360,5739,78,5739,78,5563,75.6,176,2.4,0,0,1621,22,3.1
27053100700,2227,2227,1782,80,1782,80,1637,73.5,145,6.5,0,0,445,20,8.1
27053100800,2876,2876,1961,68.2,1961,68.2,1715,59.6,246,8.6,0,0,915,31.8,12.5
27053103000,1613,1613,1192,73.9,1192,73.9,1180,73.2,12,0.7,0,0,421,26.1,1
27053103400,1940,1940,1307,67.4,1307,67.4,1144,59,163,8.4,0,0,633,32.6,12.5
27053103900,3792,3792,2523,66.5,2515,66.3,2282,60.2,233,6.1,8,0.2,1269,33.5,9.3
27053106600,2353,2353,1872,79.6,1872,79.6,1772,75.3,100,4.2,0,0,481,20.4,5.3
27053108000,3081,3081,2734,88.7,2734,88.7,2704,87.8,30,1,0,0,347,11.3,1.1
27053106000,2276,2276,1318,57.9,1318,57.9,1230,54,88,3.9,0,0,958,42.1,6.7
27053106400,1625,1625,1099,67.6,1099,67.6,1008,62,91,5.6,0,0,526,32.4,8.3
27053107600,3014,3014,2393,79.4,2393,79.4,2284,75.8,109,3.6,0,0,621,20.6,4.6
27053109000,1473,1473,1107,75.2,1107,75.2,1082,73.5,25,1.7,0,0,366,24.8,2.3
27053110500,3897,3897,2806,72,2806,72,2726,70,80,2.1,0,0,1091,28,2.9
27053122500,2844,2844,2277,80.1,2277,80.1,2260,79.5,17,0.6,0,0,567,19.9,0.7
27053108800,3093,3093,2165,70,2165,70,2054,66.4,111,3.6,0,0,928,30,5.1
27053108900,1879,1879,1451,77.2,1451,77.2,1362,72.5,89,4.7,0,0,428,22.8,6.1
27053110000,1558,1558,1238,79.5,1238,79.5,1101,70.7,137,8.8,0,0,320,20.5,11.1
27053111100,2870,2870,2269,79.1,2269,79.1,2201,76.7,68,2.4,0,0,601,20.9,3
27053111200,2539,2539,1817,71.6,1811,71.3,1764,69.5,47,1.9,6,0.2,722,28.4,2.6
27053102800,2345,2345,1674,71.4,1674,71.4,1358,57.9,316,13.5,0,0,671,28.6,18.9
27053105100,2413,2413,1801,74.6,1801,74.6,1750,72.5,51,2.1,0,0,612,25.4,2.8
27053105500,3495,3495,2743,78.5,2743,78.5,2669,76.4,74,2.1,0,0,752,21.5,2.7
27053109200,3151,3151,2345,74.4,2345,74.4,2345,74.4,0,0,0,0,806,25.6,0
27053111400,3018,3018,2357,78.1,2357,78.1,2317,76.8,40,1.3,0,0,661,21.9,1.7
27053122600,1917,1917,1613,84.1,1613,84.1,1590,82.9,23,1.2,0,0,304,15.9,1.4
27053026605,2842,2842,1833,64.5,1833,64.5,1791,63,42,1.5,0,0,1009,35.5,2.3
27053026606,3938,3938,2799,71.1,2799,71.1,2709,68.8,90,2.3,0,0,1139,28.9,3.2
27053026611,3981,3981,2905,73,2905,73,2786,70,119,3,0,0,1076,27,4.1
27053027101,5024,5024,3495,69.6,3495,69.6,3426,68.2,69,1.4,0,0,1529,30.4,2
27053027201,5180,5180,3284,63.4,3284,63.4,3200,61.8,84,1.6,0,0,1896,36.6,2.6
27053027501,3853,3853,2625,68.1,2625,68.1,2526,65.6,99,2.6,0,0,1228,31.9,3.8
27053027601,3188,3188,2326,73,2326,73,2250,70.6,76,2.4,0,0,862,27,3.3
27053105400,3293,3293,2512,76.3,2512,76.3,2254,68.4,258,7.8,0,0,781,23.7,10.3
27053107500,1622,1622,1242,76.6,1242,76.6,1204,74.2,38,2.3,0,0,380,23.4,3.1
27053101300,1445,1445,1003,69.4,1003,69.4,861,59.6,142,9.8,0,0,442,30.6,14.2
27053102600,1700,1700,1353,79.6,1353,79.6,1249,73.5,104,6.1,0,0,347,20.4,7.7
27053107000,3337,3337,2740,82.1,2740,82.1,2665,79.9,75,2.2,0,0,597,17.9,2.7
27053110900,2675,2675,2045,76.4,2045,76.4,2005,75,40,1.5,0,0,630,23.6,2
27053111500,4245,4245,3233,76.2,3233,76.2,3116,73.4,117,2.8,0,0,1012,23.8,3.6
27053022802,3049,3049,2338,76.7,2338,76.7,2296,75.3,42,1.4,0,0,711,23.3,1.8
27053021601,3771,3771,2847,75.5,2847,75.5,2762,73.2,85,2.3,0,0,924,24.5,3
27053021900,3003,3003,2101,70,2101,70,2042,68,59,2,0,0,902,30,2.8
27053022200,3979,3979,3137,78.8,3137,78.8,3039,76.4,98,2.5,0,0,842,21.2,3.1
27053023902,1612,1612,944,58.6,944,58.6,891,55.3,53,3.3,0,0,668,41.4,5.6
27053024700,2483,2483,1755,70.7,1755,70.7,1718,69.2,37,1.5,0,0,728,29.3,2.1
27053025601,2104,2104,1370,65.1,1370,65.1,1347,64,23,1.1,0,0,734,34.9,1.7
27053025603,3221,3221,2025,62.9,2025,62.9,1909,59.3,116,3.6,0,0,1196,37.1,5.7
27053026013,3641,3641,2747,75.4,2747,75.4,2704,74.3,43,1.2,0,0,894,24.6,1.6
27053005902,2287,2287,1593,69.7,1593,69.7,1413,61.8,180,7.9,0,0,694,30.3,11.3
27053008100,3185,3185,2817,88.4,2817,88.4,2688,84.4,129,4.1,0,0,368,11.6,4.6
27053010700,1880,1880,1495,79.5,1495,79.5,1416,75.3,79,4.2,0,0,385,20.5,5.3
27053020303,2698,2698,1920,71.2,1920,71.2,1779,65.9,141,5.2,0,0,778,28.8,7.3
27053020400,3947,3947,2877,72.9,2845,72.1,2588,65.6,257,6.5,32,0.8,1070,27.1,9
27053020600,1525,1525,983,64.5,983,64.5,926,60.7,57,3.7,0,0,542,35.5,5.8
27053020700,3402,3402,2525,74.2,2525,74.2,2359,69.3,166,4.9,0,0,877,25.8,6.6
27053026514,4105,4105,3274,79.8,3274,79.8,3142,76.5,132,3.2,0,0,831,20.2,4
27053026609,2282,2282,1572,68.9,1572,68.9,1560,68.4,12,0.5,0,0,710,31.1,0.8
27053001700,1889,1889,1431,75.8,1431,75.8,1352,71.6,79,4.2,0,0,458,24.2,5.5
27053005901,2653,2653,1199,45.2,1199,45.2,1067,40.2,132,5,0,0,1454,54.8,11
27053007801,1354,1354,1018,75.2,1018,75.2,964,71.2,54,4,0,0,336,24.8,5.3
27053008200,3542,3542,2577,72.8,2577,72.8,2438,68.8,139,3.9,0,0,965,27.2,5.4
27053009500,2294,2294,1796,78.3,1796,78.3,1589,69.3,207,9,0,0,498,21.7,11.5
27053009600,2970,2970,2325,78.3,2325,78.3,2164,72.9,161,5.4,0,0,645,21.7,6.9
27053021001,5010,5010,3793,75.7,3793,75.7,3607,72,186,3.7,0,0,1217,24.3,4.9
27053021200,3551,3551,2535,71.4,2535,71.4,2501,70.4,34,1,0,0,1016,28.6,1.3
27053021800,1911,1911,1222,63.9,1222,63.9,1207,63.2,15,0.8,0,0,689,36.1,1.2
27053021400,2563,2563,2050,80,2050,80,1946,75.9,104,4.1,0,0,513,20,5.1
27053021501,3448,3448,1875,54.4,1875,54.4,1761,51.1,114,3.3,0,0,1573,45.6,6.1
27053021505,3572,3572,2660,74.5,2660,74.5,2516,70.4,144,4,0,0,912,25.5,5.4
27053022801,1635,1635,1172,71.7,1172,71.7,1126,68.9,46,2.8,0,0,463,28.3,3.9
27053023200,5062,5062,3914,77.3,3914,77.3,3807,75.2,107,2.1,0,0,1148,22.7,2.7
27053023400,4878,4878,3249,66.6,3249,66.6,2954,60.6,295,6,0,0,1629,33.4,9.1
27053025100,2550,2550,1919,75.3,1919,75.3,1787,70.1,132,5.2,0,0,631,24.7,6.9
27053026403,2826,2826,1844,65.3,1844,65.3,1709,60.5,135,4.8,0,0,982,34.7,7.3
27053026510,3066,3066,2203,71.9,2203,71.9,2154,70.3,49,1.6,0,0,863,28.1,2.2
27053026512,5336,5336,3599,67.4,3599,67.4,3459,64.8,140,2.6,0,0,1737,32.6,3.9
27053026707,3921,3921,3171,80.9,3171,80.9,3080,78.6,91,2.3,0,0,750,19.1,2.9
